10	10
.	2	3	.	.	0	.	.	.	.
.	.	.	.	3	.	2	.	.	6
.	.	5	.	5	3	.	5	7	4
.	4	.	5	.	5	.	6	.	3
.	.	4	.	5	.	6	.	.	3
.	.	.	2	.	5	.	.	.	.
4	.	1	.	.	.	1	1	.	.
4	.	1	.	.	.	1	.	4	.
.	.	.	.	6	.	.	.	.	4
.	4	4	.	.	.	.	4	.	.
